だいがく: College, university
こうこう: High school
がくせい: Student
だいがくせい: College student
りゅがくせい: International student
せんせい: Teacher
～ねんせい: ...year student
せんこう: Major

わたし: I
ともだち: Friend
～さん: Mr./Ms....
～じん: ...people

いま: Now
ごぜん: A.M.
ごご: P.M.
～じ: o'clock
はん: Half

にほん: Japan
あめりか: America
～ご: ...language
～さい: ...years old
でんわ: Telephone
～ばん: number...
ばんごう: Number
なまえ: Name
なん/なに: What

あのう: Um...
はい: Yes
そうです: That's right
そうですか: Is that so?

いぎりす: Britain
おおすとらりあ: Australia
かんこく: Korea
かなだ: Canada
ちゅうごく: China
いんど: India
えじぷと: Egypt
ふぃりぴん: Philippines

あじあけんきゅう: Asian studies
けいざい: Economics
こうがく: Engineering
こくさいかんけい: International studies
こんぴゅうたあ: Computer
せいじ: Politics
せいぶつがく: Biology
びじねす: Business
ぶんがく: Literature
れきし: History

いしゃ: Doctor
かいしゃいん: Office worker
かんごし: Nurse
こうこうせい: High school student
しゅふ: Housewife
だいがくいんせい: Graduate student
べんごし: Lawyer

おかあさん: Mother
おとうさん: Father
おねえさん: Older sister
おにいさん: Older brother
いもうと: Younger sister
おとうと: Younger brother